TTTTTTTTT
T    R  T
T       T
T       .
T       T
T   R   T
T       T
T       T
TTTTTTTTT